1 1 1 1 1 1 1 1 1 1 1 1 1 1 1 1 1 1 1 1
1 0 1 0 0 0 0 0 0 0 0 0 0 0 0 0 0 0 0 1
1 0 1 0 1 1 1 1 1 1 1 1 1 1 1 1 1 1 0 1
1 2 1 0 1 0 0 0 0 0 0 0 0 0 0 0 0 1 0 1
1 0 1 0 1 0 0 6 0 0 0 0 0 0 0 0 0 1 0 1
1 0 1 0 1 0 0 0 0 0 0 0 0 0 0 0 0 1 0 1
1 0 1 0 1 0 0 0 0 0 0 0 0 0 0 0 0 1 0 1
1 0 1 0 1 1 1 1 1 1 1 1 1 1 1 0 0 1 0 1
1 0 1 0 0 0 0 0 0 0 0 0 5 2 1 0 0 1 0 1
1 0 1 0 1 1 1 1 1 1 1 1 1 1 1 0 0 1 0 1
1 0 1 0 0 0 0 0 0 0 0 0 7 2 1 0 0 1 0 1
1 0 1 0 1 1 1 1 1 1 1 1 1 1 1 0 0 1 4 1
1 0 1 0 0 0 0 0 0 0 0 0 4 3 1 0 0 1 0 1
1 0 1 0 1 1 1 1 1 1 1 1 1 1 1 0 0 1 0 1
1 0 1 0 0 0 0 0 0 0 0 0 4 3 1 0 0 1 0 1
1 0 1 0 1 1 1 1 1 1 1 1 1 1 1 0 0 1 0 1
1 0 1 0 0 0 0 0 0 0 0 0 0 0 0 0 0 1 0 1
1 0 1 1 1 1 1 1 1 1 1 1 1 1 1 1 1 1 0 1
1 4 0 0 0 0 0 0 0 0 0 0 0 0 0 0 0 0 0 1
1 1 1 1 1 1 1 1 1 1 1 1 1 1 1 1 1 1 1 1