1 1 1 1 1 1 1 1 1 1 1 1 1 1 1 1 1 1 1 1
1 0 0 0 0 0 0 0 0 0 0 0 0 0 0 0 0 0 0 1
1 0 0 1 1 1 1 1 1 1 1 1 1 1 1 1 1 1 0 1
1 0 0 1 3 1 0 0 0 1 0 0 0 1 0 0 0 1 0 1
1 0 0 1 0 0 0 1 0 0 0 1 0 0 0 1 0 0 0 1
1 0 0 1 1 1 1 1 1 1 1 1 1 1 1 1 1 1 1 1
1 0 0 0 0 0 0 0 0 0 0 0 0 0 0 0 0 0 0 1
1 0 0 1 1 1 1 1 1 1 1 1 1 1 1 1 0 0 0 1
1 0 0 0 0 0 0 0 1 1 1 2 1 0 0 0 0 0 0 1
1 0 0 0 0 4 0 0 0 1 1 0 0 0 0 0 0 0 0 1
1 0 0 0 0 0 0 0 0 0 1 0 0 0 0 0 0 4 0 1
1 0 0 1 1 0 0 1 0 0 1 0 0 0 1 0 0 0 0 1
1 0 0 1 1 0 0 1 0 0 1 0 0 0 1 1 0 0 0 1
1 0 0 0 0 0 0 0 0 0 1 0 0 0 0 0 0 0 1 1
1 1 1 5 0 1 1 1 1 1 2 0 0 0 0 0 1 1 1 1
1 0 0 0 0 1 1 0 0 0 0 0 0 0 0 0 1 0 2 1
1 0 1 0 0 1 1 0 0 0 0 0 0 1 1 0 0 0 0 1
1 0 0 0 0 0 0 0 0 1 0 0 0 1 0 0 0 6 0 1
1 7 0 0 0 0 0 0 0 0 0 0 1 1 2 0 0 0 0 1
1 1 1 1 1 1 1 1 1 1 1 1 1 1 1 1 1 1 1 1